########
##. $ ##
# .    #
##$ ####
##  #
##@ #
#####