 #########
##       #
# $##### ##
# @  .#   #
#.  $.$   #
###########