############
#.         #
############
#     #    #
#$@        #
############