      ###
      #.#
  ##### #####
 ##         ##
##  # # # #  ##
#  ##     ##  #
# ##  # #  ## #
#     $@$     #
####  ###  ####
   #### ####