######
#  .##
#  # #
#  $ #
##@  #
######