##########
#        #
# ##$### #
# #... # #
#  $#$$. #
#  * @## #
#        #
##########