  #####
###  .#
#.@$  ##
#####  ##
#. .# $ #
#$ $#   #
#       #
#########